42 4 3 1 0 0 0 42
4 4 3 0 0 0 0 0
3 3 0 0 0 0 0 0
1 0 0 0 0 0 0 0
0 0 0 0 0 0 0 0
0 0 0 0 0 0 0 0
0 0 0 0 0 0 0 0
42 0 0 0 0 0 0 42
